11111111111111111111111
10000000000010000000001
10000000P00010000000001
10000000000010000000001
1000000000001000000E001
10000000C00000000000001
10000000001110000000001
10000000000010000000001
10000001100011111111111
10000010000000000000001
10C00100000000000C00001
11111111111111111111111